#########################################
#     ....  .......   #                 #
#     .  #  . #   ....                  #
#    ..  #  . #       #          #      #
#    .   #  . #       #      #####   ####
#### . ###  . #    ####      #   #      #
#    .      .      #                    #
#    ........                           #
#             ######         #          #
#########################################